minnepinne	mojhtessaegkie
reinkalv	miesie
dataoverføring	daataseedteme
bil	bïjle
resultat	illeldahke
direktør	direktööre
vei	geajnoe
jordbær	laanten-muerjie
administrasjon	reereme
advare	vaaroehtidh
naturreservat	vaarjelimmietjahta
rektor	skuvle-åvtehke
rengjøringsassistent	sjïekedæjja
rådgiver	raeriestæjja
saksbehandler	aamhtshreerije
sekretær	tjaelije
personalrom	barkijetjïehtjele
skyllerom	skuvlemestjïehtjele
helsesøster	skïemtjesåjhtere
reaksjon	vaastahtahke
dukke	dåahka
forfatter	tjaelije
bilde	guvvie
allemannseie	gaajhkesieeke
Høyesterett	Jollemesreakta
rød	rööpses
blå	plaave
hvit	veelkes
beskrivelse	buerkiestimmie
miljø	byjreske
arbeidsgiver	barkoefaalije
arbeidssted	barkoesijjie
arbeidstaker	barkije
norsk mann	daatje
områdestyre	dajveståvroe
reinbeitedistrikt	båatsoesïjte
Reindriftsloven	Båatsoelaake
bergart	bïerjeaarhte
bosetningsområde	årromedajve
gjødsel	skorresje
dampmaskin	roehkenassemaskijne
installere	sijjiedehtedh
vogn	våågne
balkong	lïtnje
begrense	gaertjiedidh
forenkle	aelhkiedehtedh
grunnleggende	maadthvåarome
kvittering	vihtiesleahpa
lønnsmottaker	baalhkadåastoje
reklame	reklaame
selvstendig næringsdrivende	jïjtse jielemeburrie
skille	vessmedh
virkeområde	vierhkiedajve
gang	kåava
svømmehall	voejedimssavka, voejedimmessavka
personale	barkijh
melodi	musihke
buss	busse
flyplass	girtiesjåljoe
rein	bovtse
far	aehtjie
bestefar	aajja
kamp	gæmhpoe
krekling	hingsen-muerjie, goerhpen-muerjie, kreeke, gaaranassen-muerjie, krijke
selger	doekije
arkiv	våarhkoe
budsjett	beetnehsoejkesje
rumpe	ravve
mage	tjåejjie
albue	gernjere
hode	åejjie
representant	saadthalmetje, tjirkije
datamaskin	daatovre
dato	biejjie
demokrati	almeståvroe
fagforening	faagesiebrie
industri	industrije
kommunikasjon	gaskesadteme
overskrift	bijjietjaalaldahke
produkt	dorjese
produsere	darjodh
regel	njoelkedasse
rettssikkerhet	reaktatjirkeme
statsbudsjett	staatebudsjedte
storting	stoerredigkie
utstilling	vuesiehtimmie
utvalg	moenehtse
operasjon	operasjovne
naturminne	eatnememojhtese
miljøvern	byjreskevaarjelimmie
selvbilde	jïjtjeguvvie
klokke	tsåahka
elvebunn	jeanoenbetnie
lege	dåaktere
jordmor	tsegkietnie
bibliotek	gærjagåetie
revisor	revisovre
rådmann	raerienålma
kjøretøy	vuajahtahke
trygghet	jearsoesvoete
nettleser	weblohkije, viermielohkije
oppdatere	orrestehtedh
folkerett	åålmehreakta
katt	gaahtoe
dagsorden	biejjieöörnege
debatt	digkiedimmie
fordele	joekedidh
elevråd	learohkeraerie
lærling	learohke
media	meedija
publisere	bæjhkoehtidh
rasisme	tjïertevidtjie
utredning	salkehtimmie
film	filme
gymnastikksal	vïtnedimmessavka
loddrett pil	tseagkode njoele
villrein	gedtiekrievvie
minister	ministeere
møte, sammenkomst	tjåahkoe
møteleder	tjåanghkoe-åejvie
stemmerett	veeljemereakta
valgresultat	veeljemenilleldahke
talerstol	håalomestovle
meddele	bealjoehtidh
foto	tjoevkeguvvie
Utenriksdepartementet	Ålkoerïjhkedepratemeente
fugl	ledtie
annonsekostnad	bïevnese-åasa
attestere	vihtiestidh
avdeling	goevtese
avdelingsdirektør	goevtesedirektööre
Sametinget	Saemiedigkie
Sametingets president	Saemiedigkien åvtehke
President	Presideente
bibliotekar	gærjareerije
bidrag	dåarjoe
bokmerke	gærjamïerhke
småbarnsmor	tjidtjie
gutt	baernie
jente	nïejte
hund	bïenje
lite barn	maanetje
sko	gaamegh
bukser	måvhkah
t-skjorte	sissehts sjåarhtoe
brød	gaahkoe
melk	mielhkie
egg	munnie
bord	buertie
hest	hierkie
sau	sïrve
ku	govse
høne	vöönhtse
gris	snurke
tog	ruevtie-raajroe
bestemor	aahka
tøffler	låapoehgaamegh
kjole	gåptoe
jakke	tråajjoe
lue	tjohpe
tre	moere
huske	sovkehtahke
ball	tjengkere
sklie	gierese
støvel	steeblegh
fly	girtie
hus	gåetie
is	tjaste
godter	njaalkadahkh
fot	juelkie
hand	gïete
munn	njaelmie
øye	tjelmie
øre	bieljie
hår	voepte
rosa	råvsa
svart	tjeehpes
badekar	laavkome-lihtie
håndkle	njaamelijnie
såpe	såapa
vindu	klaase
seng	seangkoe
dør	okse
lys	tjoevke
bok	gærja
ballett	baalledte
billedkunst	guvvietjeahpoe
bilkolonne	bïjleraajroe
bokanmeldelse	gærjahsaernie
betalingsplan	maaksoesoejkesje
befolkningsgruppe	almehtjïerte
danse	jårrehdehtedh
digitale	digitaale
diplomati	diplomatije
disippel	learohke
dokumentvisning	tjaatsestimmie-nomme
flyktning	baataræjja
driftstilskudd	gïehtelimmesdåarjoe
elev	learohke
e-post	e-påaste
elektronisk post	elektronihken påaste
etableringsstipend	aalkoedåarjoe
EU	EE
Europeiske Union	Europan Ektiedimmie
faglitteratur	faagelidteratuvre
datafil	daatafijle
forlag	berteme
forlegger	bertije
formann	avtehke
fornavn	åvtelnomme
forurense	deerjehtidh
forvalte	stuvredh
fremmedord	ammesbaakoe
fremmedordbok	ammesbaakoegærja
fylke	fylhke
grad	tsiehkie
grunnfag	maadthfaage
grunnfagsstudium	maadthfaage-lohkeme
halvår	bieliejaepie
halvårsenhet	bieliejaepieboelhke
halvtime	bielietæjmoe
helseforetak	starneråajvarimmie
historie	histovrije
ILO-konvensjonen	ILO-konvensjovne
infobank	bïevnesbaanghke
inntektsgrunnlag	dïenesjimmie
interaktive tjenester	interaktijve dïenesjh
jobbintervju	barkoegoerehtse
jordklode	eatneme
kalender	biejjielåhkoe
kino	kinove
kjedelig	ov-rovne
kommuneordfører	tjïelten åejvie
kontorist	kontovrebarkije
kostnadsfritt	åesehts
kulturarv	aerpiegaerie
kultursenter	kultuvrejarnge
kunstner	tjiehpiedæjja
kvote	veahka
litteraturpris	lidteratuvresjïele
lokalitet	byjreske
lokalt	byjrehks
læring	lïereme
læringsnett	ööhpehtimmienedte
læringssenter	lohkehtimmiejarnge
lønnstrinn	baalhkatsiehkie
lån	mïetege
mappesystem	maabpesysteme
matbutikk	beapmoebovre
matlager	beapmoegorrese
mediaklipp	meedija-bietskh
menneskerett	almetjereakta
miljøsenter	byjreskejarnge
musikk	musigke
rådgiver	raerije
nettside	nedtebielie
nettsted	nedtesijjie
nettvettregler	nedtevihte njoelkedassh
Norske Reindriftssamers Landsforbund	Nöörjen Båatsoe Rijhkesiebrie
notat	notaate
månedsmagasin	askeplaerie
nyhetsformidler	saarnoje
næringsgruppe	jieliemassedåehkie
næringsoppgave	jielemesbïevnese
oppvekstsjef	byjjenimmie-åejvie
oppvekstvilkår	byjjenimmesnuepie
parti	krirrie
Det norske Arbeiderpartiet	Nöörjen barkoebielienkrirrie
Venstre	Gårroebielien krirrie
Fremskrittspartiet	Evtiedimmienkrirrie
Sosialistisk Vensterparti	Sosialistihke Gårroebielienkrirrie
Rød Valgallianse	Rööpses Veeljemekrirrie
pressemelding	preessebïevnese
protokoll	buertiegærja
reindriftsforvaltning	båatsoereereme
reindriftsområde	båatsoedajve
reindriftsorganisasjon	båatsoeorganisasjovne
rengjøringsassistent	sjeakoje
restaurering	dåvveme
saksbehandlingstid	aamhtshreeremsbaelie
samarbeidsoppgave	laavenjasse
samarbeidsprosjekt	ektiebarkoeprosjeekte
Sameloven	Saemielaake
regjering	reerenasse
bokmål	daaroengïele
nynorsk	orredaaroengïele
midtpunkt, sentrum, torg	jarnge
demokrati	demokratije
ekspert	tjiehpije
Norge	Nöörje
høydekurve	jalloegåevie
kart	kaarhte
landskapskart	dajvenkaarhte
fjellkart	vaerienkaarhte
levende landskap	jielije eatneme
forme	jarkoestidh
reise av stede med	voelkehtidh
atlas	atlaase
elvdal	skårnjoe
flyttblokk	plassa
havbunn	mearoebetnie
tidevann	flööreme njååreme
kast av garn	viermieh jadtehtidh
hotell	hotelle
besøksaddresse	guessiesijjie
alpinanlegg	gïerestallemesijjie
snøbrett, snowboard	lopmefealloe
løvskog	boelte
granskog	råhtoe
furuskog	beetsuve
contortafuru	contorta
furu	bietsie
varmekjær	baahke-lyjhkede
enkel	aelhkie
oppfinnsom	hæhtadihks
landskap	eatneme
høyblokk	jollegåetie
park	såafoe
astma	astma
trikk	trihke
drosje	taksije
grotte	haevtie
hurtigbåt	spaajhtevïnhtse
transportnæring	skovhtestimmieveasoe
skjell	skaaltjoe
glattskurt	speanjoeh
musikinstrument	tjoejehtahke
vindkraftverk	bïegkefaamoevierhkie
vannkraft	tjaetsiefaamoe
utbygging	lissietseegkeme
innlandsfylke	maadterisnie fylhkh
turisthytte	turistehæhtjoe
nedbør	træjpoe
biovitenskap	biodaajroe
kunstgjødsel	urresteskorresjh
folkerik	almetjijes
midnattssol	Jïjjegåårtesebiejjie
søring	åarjehke
norsk	nöörjehke
svensk	sveerjehke
tundra	doedtere
savanne	savanne
ørkenlandskap	saadtergemaajeh
plantegift	sjædtoe-dilhkesh
naturmedisin	sjædtoedaalhkesh
kvegfarm	govsegaertene
legevitenskap	dååkteredaajroe
regntid	abredahke
bankkonto	baanghkekonto
term	terme
kullgruve	tjïrregruva
kirke	gærhkoe
skole	skuvle
rådhus	raeriengåetie
forene	ektiedidh
sammenhengende	ektenes
hevde	bajjehtidh
omfatte	feerhmedh
rekkefølge	ikte-mearan
redaktør	redaktööre
representant	tjirkije
trinn	daltese
ugyldig	ovdæjpele
åpenbart	tjïelkes
havn	sïelkedahke, staarhvoe
tingrett	digkiereakta
faktum	saetniesdaajroe
medhjelper	viehkiehtæjja
overvåke	vååksjelidh
tvil	juerie
trener	heerjehtæjja
miljøteam	byjreskedåehkie
miljøarbeider	byjreskebarkije
fakkeltog	govkijeraajroe
fylkeskommun	leeneståvroe, fylhketjïelte
heltid	elliestïjje, abpetïjje
hovedkandidat	åejviekandidaate
skolegård	skuvlensjåljoe
markere misnøye	plonterdidh
fotballmål	tjiektjesraavramååle, juelkietjengkeremååle
klatrevegg	gahpevïedtje
fordeling	joekedimmie
konservativ	konservatijve
radikal	radikaale
pengesekk	beetnehvoesse
kongens råd	gånkanraerije
utenriksminister	ålkoerïjhkeministeere
barne- og familieminister	maana- jïh fuelhkieministeere
barne- og familiedepartementet	maana- jïh fuelhkiedepartemeente
flertallsregjering	jienebelåhkoereerenasse
regjeringskonferanse	reerenassetjåanghkoe, reerenassetjåahkoe
flypassasjer	girtiefeelije
tariffoppgjør	tariffelatjkoe
arbeidstaker, lønnstaker	baalhkadåastoje, barkoedåastoje
bokhandel	gærjabovre
keramiker	keramikere
næringslivets hovedorganisasjon	jielemi åejvieorganisasjovne
lockout	lockoute
massakre	bovvelimmie
mediebedrift	medijasïelte, medijasielske
avisredaksjon	plaerieredaksjovne
ladet ord	domtsbaakoe
flypassasjer	girtiefeelije
salgssjef	doekemeåejvie
butikksenter	bovrejarnge
pensjonist	pensjovniste
reklamefilm	reklaamefilme
midtpunkt	jarnge
gjeng	håajje
tast	båaloe
bytterett	låtnemereakta
forbrukerrådet	utnijeraerie
postordre	påasten tjïrrh dyngkeme
bagett	bagette
posesuppe	pååssajoptse, passajoptse
hurtigmat	sneehpesmaalese
kalori	kalorije
gjennomsnittsfamilie	gaskemedtiefuelhkie
grammofon	grammofovne
lydfil	tjoejefilme
stumfilm	tjoejehtsfilme
gjennomsnitt	gaskemedtie
rasjoneringskort	tsibpeldimmeskåarhte
bolignød	gåetievaanoe
rock	rocke
magisk	åavtoes
ferievane	eejehtimmiesviejsjie
ferie	eejehtimmie
pakketur	peehkemetuvre
syden	åarjese
flyreise	girtiefealadimmie
teknisk	tekniske
CD	CDe
kabel-tv	kabele-tv
kommersielt	åesiestimmes
collage	collasje
smaktilsetning	læssedsaelmie
merkeklær	mïerhkevaarjoeh
lommepenger	låammebeetnegh
smink	sminhke
spillautomat	spïeleautomaate
fritidsutstyr	eejehtimmietjognh
motorkjøretøy	motovrevuajahtahke
montasje	montaasje
utstillingsdukke	vuesiehtimmesdåahka
bildemontasje	guvviemontaasje
reklameavtale	reklaamelatjkoe
overleve	bïerkenidh
miljøproblem	byjresketjoepere
forbruk	åtnoe
gjenbruke	mubpesth nuhtjedh
atom	atome
atomkraft	atomefaamoe
forbrukerlov	utnijelaake
reklamasjonsfrist	aangkerdimmesraaje
returnere	bååstede seedtedh, råaptede seedtedh
returpakning	råaptoehpaantje, bååstedepaantje
Miljøinformasjonsloven	Byjreskebïevneselaake
miljøfarlig	byjreskevaahra
sprøytemiddel	stratjkomemehtie
formynder	åeliealmetje
hjemlån	hïejmelööneme
stereo	stereove
ytre kraft	bæjngoldsfaamoe
indre kraft	sisnjeldsfaamoe
landform	laanteguvvie
smeltvann	ruvvesketjaetsie
undersiden av isbre	dielhtienuelie
grave opp	ööledh
isbrefront	dielhtienjuenie
bulldoser	bulldovsere
slå en bit av kanten på noe	smeelehtidh
virvle	hïspedh
sirkelform et hull i elv	krovhte
hule ut	guhpedh
jettegryte	jïekngekrovhte
dalbunn	daeliemehkie
loddrett	tseagkode
elvegjel	garhpe
dansketiden	dansketïjje
bryte ut	laktedh
grufull	ïskeres
jordeiendom	jåarta
union	unijovne
gjøre fattig	njerredh
stattholder	rijhkenåvtehke
svett	bïevestahke
sjørøver	mearoerapmere
byggningsmaterial	bigkemasse
fossekraft	garsefaamoe
sagbruk	saakevierhkie, sååkesjhvierhkie
skipsverft	skïhpebigkemevierhkie
skipsfart	skïhpevalkese
kobberverk	kåahperevierhkie
jernverk	ruevtievierhkie
veinett	geajnaviermie, geajnoeviermie
symmetri	symmetrije
eksaminere	dïerhkesjidh
folketelling	almetjelohkeme
historiker	histovrikere
konfirmasjonslov	skyllemelaake
skolelov	skuvlelaake
omgangsskole	juhtijeskuvle
kirkebok	gærhkoegærja
tukthus	pliktegåetie
brennmerke	svirremïerhke
flyttsame	juhtijesaemie
nomad	johtehtjæjja
høste	ribledh
vild	hurkies
kven	kveene
romani, sigøyner	romalmetje
fangeleir	faangkeleejre
barnehjem	maanahïejme
jøde	juvdelaasje
kaptein	kapteejne
marine	marijne
sjøsyke	mearoegaksjehtasse
gatenett	gaatenviermie
arkitekt	arkitekte
markplanlegger	laantesoejkesjæjja
byplanlegger	staaresoejkesjæjja
spinner	butnije
spinnemaskin	butnememaskijne
hjemmelaget	jïjtjedorjeme
industrielle revolusjonen	industrije revolusjovne
kjennbar, merkbar	damtemes
arbeidskrevende	barkoes
jernkonstruksjon	ruevtiekonstruksjovne
lokomotiv	lokomotijve
gruvegang	gruvagohpege
lastepram	leessemepluahta
telegraf	telegraafe
telegrafnett	telegraafeviermie
morse-alfabete	morsealfabeete
jernmalm	ruevtiemaalme
dampskip	roehkenasseskïhpe
elektromagnetisk	elektromagnetiske
telegrafist	telegrafiste
ta i bruk	åtnose vaeltedh
industriby	industrijestaare
forurenset	deerjeldihkie
forurensing	deerjeldahke
oppfinner	gaavnehtæjja
arbeidsseminar	barkoeseminaare
hyttetur	hæhtjoemehkie
gruppepress	dåehkie-dïedte
bløffmaker, bedrager, svindler, kjeltring	bearehke
prisende, rosende	heeveles-laakan, heeveles-ligke
redsel, angst, grøsse	asvedidh
kammerherre	kammarehïerre
slep	slaepie
skille seg, være forskjellig	joekehtadtedh
ombestemme seg	eajparostedh
rose, skryte av	heevedh, girmedh, heevestidh
omfavne	gaanedidh, gaanestidh, faerhmiestidh
urettvis, urettferdighet	ovrïektesvoete
politisk makt	politihkefaamoe
homofili	homofïjlije
homofil	homofïjle
klesfabrikk	gaarvoefabrihke, vaarjoefabrihke
bilist	bïjlevuejije
partigruppe	krirriedåehkie
fagkomité	faagemoenehtse
den fjerde statsmakten	njealjede staatefaamoe
moteklær	daaletje vaarjoeh
boikott	vuastalimmie
førsteside	voestessæjroe
stortingsvalg	stoerredigkieveeljeme
stortingssalen	stoerredigkiesavka
stortingspresident	stoerredigkien presideente
diplomatlosje	diplomatijelosje
presselosje	presselosje
stortingsrepresentant	stoerredigkietjirkije, stoerredigkiesaadthalmetje
finansminister	finanseministere
saksgang	aamhteseöörnege
skateboard	gaenkerepreejre, skateboarde
napoleonskrigen	napoleonen-dåaroe
løsrive	loevenehtedh
uavhengig nasjon	jïjtjereereme nasjovne
badestrand	voejedimmesgaedtie
kulturhus	kultuvregåetie
rideklubb	rijremesiebrie
lokalpolitiker	lïhkesdajvepolitihkere, voengepolitihkere
snøbrøyting	lopmeröönjeme
trontale	trovnehåalome
talerstol	håalomestovle
propaganda	propaganda
hitlerjugend	hitlerjugende
snakke, fortelle	soptsestidh
våge, tore	jolkedh, doestedh, tjoerkedidh
reklamebyrå	reklaamekontovre
kuvøse	kuvööse
høring	govlehtimmie
invasjon	ritneme
amerikanske kongressen	ameriken kongresse
motstandsgruppe	vuastalimmesdåehkie
terrorist	terroriste
samvittighetsfull, pliktoppfyllende	tjællohke
gå omkring, spasere	vaadtsehtjidh
klesstil, mote	daaletjevaarjoeh, daaletjegaarvoeh, vaarjoeh vuekie
høvisk, vakker, høflig	dåajmijes
leserinnlegg	lohkijentjaalege
kongeskip	gunkies-skïhpe
folkeskole	almetjeskuvle
skolebyggning	skuvlegåetie
skoletillbud	skuvlefaaleldahke
riksrettssak	rïjhkereaktanaamhtese
stemmelokale	veeljemesijjie
utnevne	nammoehtidh
felle en dom	doepmedh
unionsmerke	unijovnemïerhke
skriftspråk	tjaelemegïele
nynorsk	orredaaroen gïele
maktkamp	faamoegæmhpome
møtested	gaavnedimmiesijjie
bryllup atmosfære	hïeje-aajmoe
grunnlegger	tseegkije
sildesalat	sildiesalaate, sildiesalaatese
plukke ut	veeljedh
greit	hijven
tilskuer	vuartasjæjja
folkevalgt	almetjiveeljeme
å si	jiehtedh
bli avskaffet	orrijidh
fastsette, beslutte, slå fast	nænnoestidh
tilværelse	veasome
befolkningsvekst	almetje-jeananimmie
demokratisk	demokratiske
veltrent	saavrehks
avgrenset (geografisk)	gaertjieldihkie
arbeidskraft	barkijh
eneveldig	aajnereerije
leilending	lååjkere
utbygging	lissiebïgkeme
tvert imot	vuestelen
arbeidsledighetstrygd	barkohtsmaaksoe
bønneskrift	tjaalege
pakkare, pakkerske	tsagkije
transportmiddel	dïeske
statsborgerskap	staaten-årroedahke
på vegne av	sijjeste
oppfatte	utnedh
dra over til	nillede bielien vuelkedh
statsborger	staaten-årroje
Rocky Mountains	Rocky Mountains
protestantisk	protestantiske
negativ	negatijve
positiv	positijve
organisasjon	organisasjovne
privatisere	privatiseredh
part	paarhte
megle	liktedh
meglingsfrist	likte-mierie
å kompromisse	mietedh
pengebeløp	beetneh-åesie
begå moralsk feilsteg	tjaajalgovvedh
bedre seg	fahkoeh ålma
presse	presse
idrettsstadion	gaarsjestadijumme, gaarsjestadijove
springe bort	leevhkedh, löövhkedh
rent	raajnes
furu	bietsie
tranebær	bealhtoen-muerjie, gieken-muerjie, biekeren-muerjie, pluevien-muerjie
tannhelsetjeneste	baeniehealsoesåjhtoe
tannhelsetjeneste	baeniesåjhtoe
volleyball	vollytjengkere
nyhetsbyrå	saerniebyrå
modell	modelle
porto	påastemïerhke
fryser	gilmehtahke
bli oppgitt, resignere	gåhkalidh
tidslinje	tïjjeraajroe
kjøpepress	åesteme-tjibrenassh
returporto	båastoeh-påastemïerhke
marked	maarhna
geografisk	geografiske
observatorium	observatorijumme
høydeforskjell	jalloejoekehtse
innvandre	sïjse juhtedh
nedbørfelt	måekie-dajve
møte, sammenkomst	tjåahkoe
på verdensbasis	veartanisnie
tilfeldig	veajkoej
gatehjørne	gaatene-skaavhte
forsenkning i fjell	liekie
havavsetning	mearoelaahpehtsh
jordskorpeplate	eatnemen bijjieskierie
selvfølgelig	hævvi
